
F 139,90,43



WE textures/Lin-Shuang-Sword.xpm
NO textures/stn.xpm


EA textures/miku.xpm

SO textures/Lordvoldemort.xpm

C       21,185,229


1111111111111111111111
10000000000000000000001
10000000000E00000000001
1111111111111111111111