SO textures/Lordvoldemort.xpm
NO textures/stn.xpm
WE textures/Lin-Shuang-Sword.xpm
EA textures/miku.xpm
F 139,90,43
C 21,185,229

1111111111111111111111
1000000000000000000001
1000000000000000000001
1000000000000000000001
1000000000000000000001
1000000000000000000001
1000000000000000000001
10000000000N0000000001
1111111111111111111111