



		SO textures/Lordvoldemort.xpm

														NO textures/stn.xpm


		WE 		textures/gregory-ligman-brick-02.xpm
	


EA		  	textures/miku.xpm


F    	 139,90,43	  






C 		121,185,229 





11111111111111
10000000000011
1000000000000N1
10000000000011111
10000000000000001
100000000000001111
1000000000000000001
111111111111101111
11011 11111110111
1111111111111111



